...####...
....##....
###....###
....##....
##..##..##
..........
\robot 2 2

