..........
.#......#.
..#....#..
...#..#...
....##....
...#..#...
..#....#..
.#......#.
..........


