....................
.#......#..#......#.
..#....#....#....#..
...#..#......#..#...
....##........##....
...#..#......#..#...
..#....#....#....#..
.#......#..#......#.
....................
....................
.#......#..#......#.
..#....#....#....#..
...#..#......#..#...
....##........##....
...#..#......#..#...
..#....#....#....#..
.#......#..#......#.
....................